%%%%%%%%%%%%%%
% B %$$$$% B %
%$$$$%%%%$$$$%
%$$$$%%%%$$$$%
% % $$%%$$ % %
%$$  %  %  $$%
%  $$$$$$$$  %
%$$$$$  $$$$$%
%$$$$$  $$$$$%
%  $$$$$$$$  %
%$$  %  %  $$%
% % $$%%$$ % %
%$$$$%%%%$$$$%
%$$$$%%%%$$$$%
% B %$$$$% B %
%%%%%%%%%%%%%%
