%%%%%%%%%%%%%%%%%%%%%%
%B          R        %
%                 $  %
%          $$$$$$$$  %
%$$$$$$$$         $R %
%                 $  %
%   $$$$$$$$$        %
%                    %
%  R        $$$$$$$  %
%   $$$$$$$$$        %
%%%%%%%%%%%%%%%%%%%%%%
