%%%%%%%%%%%
% B       %
%         %
%         %
%       B %
%%%%%%%%%%%