%%%%%%%%%%%%%%
%  $ E       %
%B $         %
%            %
%            %
%            %
%            %
%            %
%%%%%%%%%%%%%%
